                                
       1555
       1   111111111111111111111 
       1   1   1                   
       1   1   1                   
       1   1   1                   
       1   1   1                   
       1   1   1                   
       1   1   1                   
       1   1   5    111551111111 
       1   1   5    111  1        
       1   1   11111111  1
       1   1   11111111  1    2 
       1   1   11111111  1  
       1   1   11111111  1 
       1   1   11111111  1  
       1       11111111  5 
11111111111111111111111111111111
