                                
                                
1111111111111111111111111111111111
                   55           
         x         5p           
   1111111111111111111111111    
   1         B                  
   1         1                  
   1         1                  
   1         1                  
   1         1                  
   1         1                  
   1         1             1    
AAA1         1             1 k  
   1    2    1             11111
   1         1           5 1    
   1  11111  1   6  6  6 b 1 a  
11111111111111111111111111111111
