                                
                                
1111111111111111111111111111111111
            55                 
           p55                 
   1111111111188888881     
   1         B       1          
   1         B       1
   1         B       1
   1         199999991              
   1         1       5  k     1 
   1         1       1111111111         
   1         1       1          
AAA1         1       1  k     
   1    2    1       11111155511
   1         1       1     15 1 
   1  11111  1       1 a b  1 1 
11111111111111111117111111111711
Indice : ce sont les "Koopas" qui vous permettent d'ouvrir les portes.
